#####
#@$.#
#####
;
  ########
##       #
#    b   #
#    B   #
#  .$@$. #
#### $   #
   # .   #
   #    ##
   #####
;
#########
###@#####
#.$$  #.#
### $   #
###     #
#.    ##
########