#####
#@Yy#
#####
;
  ########
##       #
#    b   #
#    B   #
#  gG@Rr #
#### Y   #
   # y   #
   #    ##
   #####
;
#########
###@#####
#yYY  #y#
### Y   #
###     #
#y    ##
########